GE-Phase_stroke_start_ms,GE-Phase_stroke_end_ms,GE-Phase_stroke_duration,Buffer_ms,Tier,Value,Begin_ms,End_ms,Duration
5497,5597,100,200,GE-Phrase,201,5298,6216,1318
5497,5597,100,200,NTB,&he,4203,5486,1683
5497,5597,100,200,NTB,eles tinham essa turma,5486,6644,1558
6762,7229,467,200,GE-Phrase,202,6216,7612,1796
6762,7229,467,200,NTB,então era a turma do bairro,6644,7782,1538
8445,8879,434,200,GE-Phrase,203,7612,9471,2259
8445,8879,434,200,NTB,e aí tinha gente,8039,9626,1987
9938,11306,1368,200,GE-Phrase,204,9471,12020,2949
9938,11306,1368,200,NTB,Selênio,10619,11522,1303
15034,15468,434,200,GE-Phrase,205,13467,16449,3382
15034,15468,434,200,NTB,e atravessando a Amazonas,14475,17254,3179
17115,17983,868,200,GE-Phrase,206,16449,17983,1934
17115,17983,868,200,GE-Phrase,207,17983,19317,1734
17115,17983,868,200,NTB,do outro lado,17254,18257,1403
18550,19317,767,200,GE-Phrase,207,17983,19317,1734
18550,19317,767,200,GE-Phrase,208,19317,20687,1770
18550,19317,767,200,NTB,a continuação da Selênio,18986,21358,2772
19817,20417,600,200,GE-Phrase,208,19317,20687,1770
19817,20417,600,200,NTB,a continuação da Selênio,18986,21358,2772
23638,24372,734,200,GE-Phrase,209,23217,24642,1825
23638,24372,734,200,NTB,eu acho,23217,24876,2059
25190,25844,654,200,GE-Phrase,210,24642,25844,1602
25190,25844,654,200,GE-Phrase,211,25844,28868,3424
25190,25844,654,200,NTB,e aí ali,24876,26224,1748
25844,26986,1142,200,GE-Phrase,211,25844,28868,3424
25844,26986,1142,200,NTB,tinha muita gente que era da Japão,26615,29137,2922
29246,29529,283,200,GE-Phrase,212,28868,30163,1695
29246,29529,283,200,NTB,e que <descia> pra [/1],29137,32623,3886
34333,35024,691,200,GE-Phrase,213,33633,35467,2234
34333,35024,691,200,NTB,era povo da região assim,34199,35962,2163
35633,36100,467,200,GE-Phrase,214,35467,36402,1335
35633,36100,467,200,NTB,era povo da região assim,34199,35962,2163
35633,36100,467,200,NTB,mas &m [/1],35962,36289,727
35633,36100,467,200,NTB,meio de perto,36289,37581,1692
41211,41745,534,200,GE-Phrase,215,40911,42170,1659
41211,41745,534,200,NTB,sempre era uma turma muito grande assim,41332,42909,1977
46903,47304,401,200,GE-Phrase,216,46604,47703,1499
46903,47304,401,200,NTB,aí minha mãe conheceu meu pai lá,46583,48256,2073
54274,54908,634,200,GE-Phrase,217,53807,55335,1928
54274,54908,634,200,NTB,nem tinham interesse um pelo outro,53575,55454,2279
60507,60941,434,200,GE-Phrase,218,59974,60941,1367
60507,60941,434,200,GE-Phrase,219,60941,62246,1705
60507,60941,434,200,NTB,minha mãe gostava de outro menino,59567,60769,1602
60507,60941,434,200,NTB,então assim,60769,61119,750
60507,60941,434,200,NTB,é &ou [/1],61119,61878,1159
61141,61538,397,200,GE-Phrase,219,60941,62246,1705
61141,61538,397,200,NTB,é &ou [/1],61119,61878,1159
64222,64522,300,200,GE-Phrase,220,63655,64929,1674
64222,64522,300,200,NTB,eles eram só amigos e,62775,65247,2872
65362,66609,1247,200,GE-Phrase,221,64929,67032,2503
65362,66609,1247,200,NTB,nũ,66284,67570,1686
72750,73497,747,200,GE-Phrase,222,72217,74052,2235
72750,73497,747,200,NTB,nũ sei [/2],72978,73497,919
72750,73497,747,200,NTB,nũ sei por quê,73497,74483,1386
77928,78329,401,200,GE-Phrase,223,76839,78607,2168
77928,78329,401,200,NTB,quando ela já era adulta,76970,79218,2648
88703,89371,668,200,GE-Phrase,224,88270,90113,2243
88703,89371,668,200,NTB,eu nũ sei a ordem,88568,89410,1242
88703,89371,668,200,NTB,na verdade,89410,90328,1318
90446,91281,835,200,GE-Phrase,225,90113,92132,2419
90446,91281,835,200,NTB,sei se ela já tinha,90328,91366,1438
90446,91281,835,200,NTB,ido pra Vitória,91366,92825,1859
92266,93453,1187,200,GE-Phrase,226,92132,94618,2886
92266,93453,1187,200,NTB,ou nũ tinha,92825,94401,1976
95085,96453,1368,200,GE-Phrase,227,94618,96453,2235
95085,96453,1368,200,GE-Phrase,228,96453,97547,1494
95085,96453,1368,200,NTB,se eles foram separados,95942,96835,1293
96719,97046,327,200,GE-Phrase,228,96453,97547,1494
96719,97046,327,200,NTB,nũ sei direito,96835,97540,1105
100226,100434,208,200,GE-Phrase,229,99759,100667,1308
100226,100434,208,200,NTB,alguma coisa assim,100303,101138,1235
105966,106513,547,200,GE-Phrase,230,105600,106722,1522
105966,106513,547,200,NTB,aí eles foram,105821,106851,1430
109397,110395,998,200,GE-Phrase,232,108708,110395,2087
109397,110395,998,200,GE-Phrase,233,110395,111156,1161
109397,110395,998,200,NTB,do casamento do meu pai com a [/2],109300,111080,2180
110561,111156,595,200,GE-Phrase,233,110395,111156,1161
110561,111156,595,200,GE-Phrase,234,111156,111929,1173
110561,111156,595,200,NTB,do casamento do meu pai com a [/2],109300,111080,2180
110561,111156,595,200,NTB,do anterior,111080,111933,1253
111611,111929,318,200,GE-Phrase,234,111156,111929,1173
111611,111929,318,200,GE-Phrase,235,111929,112681,1152
111611,111929,318,200,NTB,do anterior,111080,111933,1253
111611,111929,318,200,NTB,com a minha mãe,111933,112746,1213
112681,113499,818,200,GE-Phrase,236,112681,114133,1852
112681,113499,818,200,NTB,nũ teve [/2],112746,114643,2297
114766,115598,832,200,GE-Phrase,237,114133,116060,2327
114766,115598,832,200,NTB,nũ foi direta,114643,116238,1995
116060,116561,501,200,GE-Phrase,238,116060,116561,901
116060,116561,501,200,GE-Phrase,239,116561,117311,1150
116060,116561,501,200,NTB,assim,116238,116571,733
116060,116561,501,200,NTB,nũ foi que ele,116571,117341,1170
116827,117311,484,200,GE-Phrase,239,116561,117311,1150
116827,117311,484,200,GE-Phrase,240,117311,118321,1410
116827,117311,484,200,NTB,nũ foi que ele,116571,117341,1170
116827,117311,484,200,NTB,conheceu minha mãe,117341,118182,1241
117311,118074,763,200,GE-Phrase,240,117311,118321,1410
117311,118074,763,200,NTB,conheceu minha mãe,117341,118182,1241
117311,118074,763,200,NTB,e quis separar,118182,118917,1135
118751,119133,382,200,GE-Phrase,241,118321,119455,1534
118751,119133,382,200,NTB,nem nada disso,118917,119457,940
120222,120587,365,200,GE-Phrase,242,119455,120587,1532
120222,120587,365,200,GE-Phrase,243,120587,121688,1501
120222,120587,365,200,NTB,tipo eles &d[/1],119457,120726,1669
120222,120587,365,200,NTB,ele separou,120726,122483,2157
121087,121688,601,200,GE-Phrase,243,120587,121688,1501
121087,121688,601,200,GE-Phrase,244,121688,123689,2401
121087,121688,601,200,NTB,ele separou,120726,122483,2157
122321,122525,204,200,GE-Phrase,244,121688,123689,2401
122321,122525,204,200,NTB,ele separou,120726,122483,2157
122321,122525,204,200,NTB,e aí veio pra cá,122483,123738,1655
124156,124823,667,200,GE-Phrase,245,123689,125019,1730
124156,124823,667,200,NTB,e reencontrou minha mãe,123738,124858,1520
126854,127187,333,200,GE-Phrase,246,126588,127438,1250
126854,127187,333,200,NTB,nũ sei qual foi a diferença,126614,127898,1684
14903,15374,471,200,GE-Phrase,201,14551,15962,1811
14903,15374,471,200,NTB,crítica até hoje,14522,15590,1468
19801,20304,503,200,GE-Phrase,202,19225,21244,2419
19801,20304,503,200,NTB,a questão da procedência,19206,20615,1809
21244,22444,1200,200,GE-Phrase,203,21244,23590,2746
21244,22444,1200,200,NTB,não só na cultura  grega,22015,23045,1430
23590,24657,1067,200,GE-Phrase,204,23590,25583,2393
23590,24657,1067,200,NTB,como a gente sabe que na cultura hebraica,23045,24645,2000
23590,24657,1067,200,NTB,foi também,24645,25227,982
26149,26650,501,200,GE-Phrase,205,25583,27102,1919
26149,26650,501,200,NTB,judaico-cristã,26302,27144,1242
27102,27573,471,200,GE-Phrase,206,27102,28175,1473
27102,27573,471,200,NTB,por muito tempo,27144,28520,1776
29662,30211,549,200,GE-Phrase,207,28909,30211,1702
29662,30211,549,200,GE-Phrase,208,30211,31227,1416
29662,30211,549,200,NTB,me diga com quem andas,29821,31127,1706
30535,31227,692,200,GE-Phrase,208,30211,31227,1416
30535,31227,692,200,GE-Phrase,209,31227,32180,1353
30535,31227,692,200,NTB,me diga com quem andas,29821,31127,1706
30535,31227,692,200,NTB, dir-te-ei as manhas que tens,31127,32422,1695
31227,31563,336,200,GE-Phrase,209,31227,32180,1353
31227,31563,336,200,NTB, dir-te-ei as manhas que tens,31127,32422,1695
34420,35220,800,200,GE-Phrase,210,33386,35977,2991
34420,35220,800,200,NTB,qual é a sua linhagem,34139,35470,1731
35977,36656,679,200,GE-Phrase,211,35977,36656,1079
35977,36656,679,200,GE-Phrase,212,36656,38111,1855
35977,36656,679,200,NTB,porque,36395,36691,696
35977,36656,679,200,NTB,diferente do que a gente pensa,36691,37919,1628
37311,37748,437,200,GE-Phrase,212,36656,38111,1855
37311,37748,437,200,NTB,diferente do que a gente pensa,36691,37919,1628
37311,37748,437,200,NTB,cê não tinha documento igual cê tem agora,37919,40341,2822
38578,39165,587,200,GE-Phrase,213,38111,40273,2562
38578,39165,587,200,NTB,cê não tinha documento igual cê tem agora,37919,40341,2822
40749,41072,323,200,GE-Phrase,214,40273,41072,1199
40749,41072,323,200,GE-Phrase,215,41072,41994,1322
40749,41072,323,200,NTB,em que cê tem,40341,41383,1442
41478,41994,516,200,GE-Phrase,215,41072,41994,1322
41478,41994,516,200,GE-Phrase,216,41994,43251,1657
41478,41994,516,200,NTB,a sua família garantida por documento,41383,43541,2558
42181,43134,953,200,GE-Phrase,216,41994,43251,1657
42181,43134,953,200,GE-Phrase,217,43251,44383,1532
42181,43134,953,200,NTB,a sua família garantida por documento,41383,43541,2558
43910,44383,473,200,GE-Phrase,217,43251,44383,1532
43910,44383,473,200,GE-Phrase,218,44383,47057,3074
43910,44383,473,200,NTB,porque você é filho de nũ sei o que,43541,44810,1669
44772,47057,2285,200,GE-Phrase,218,44383,47057,3074
44772,47057,2285,200,GE-Phrase,219,47057,48898,2241
44772,47057,2285,200,NTB,cê tem certidão de nascimento,46309,47266,1357
47057,47597,540,200,GE-Phrase,219,47057,48898,2241
47057,47597,540,200,NTB,nũ tinha isso,47266,47986,1120
49364,51790,2426,200,GE-Phrase,220,48898,51790,3292
49364,51790,2426,200,GE-Phrase,221,51790,54858,3468
49364,51790,2426,200,NTB,cê se identifica falando da sua linhagem,50682,53234,2952
52195,52715,520,200,GE-Phrase,221,51790,54858,3468
52195,52715,520,200,NTB,cê se identifica falando da sua linhagem,50682,53234,2952
54858,56163,1305,200,GE-Phrase,222,54858,56457,1999
54858,56163,1305,200,NTB,além de você se identificar meio que falando da sua linhagem,54779,57526,3147
59862,60458,596,200,GE-Phrase,223,58999,60458,1859
59862,60458,596,200,GE-Phrase,224,60458,61917,1859
59862,60458,596,200,NTB,também identifica,58812,60426,2014
59862,60458,596,200,NTB,se os seus eram boas pessoas,60426,62199,2173
60458,61351,893,200,GE-Phrase,224,60458,61917,1859
60458,61351,893,200,NTB,se os seus eram boas pessoas,60426,62199,2173
62688,63532,844,200,GE-Phrase,225,62325,63532,1607
62688,63532,844,200,GE-Phrase,226,63532,65097,1965
62688,63532,844,200,NTB,porque isso vai mudar totalmente a impressão que vão ter de você,62199,65120,3321
63532,64608,1076,200,GE-Phrase,226,63532,65097,1965
63532,64608,1076,200,NTB,porque isso vai mudar totalmente a impressão que vão ter de você,62199,65120,3321
65513,65945,432,200,GE-Phrase,227,65097,66460,1763
65513,65945,432,200,NTB,aquela coisa mesmo de interior,65446,66585,1539
69674,70150,476,200,GE-Phrase,228,69194,71142,2348
69674,70150,476,200,NTB,filha do fulano,69701,70723,1422
72169,73817,1648,200,GE-Phrase,229,71142,73817,3075
72169,73817,1648,200,GE-Phrase,230,73817,75411,1994
72169,73817,1648,200,NTB,<porque o pai é ruim>,72826,73776,1350
74276,74781,505,200,GE-Phrase,230,73817,75411,1994
74276,74781,505,200,NTB,&he qual que é a sua família,74202,75455,1653
90723,91096,373,200,GE-Phrase,231,90374,91461,1487
90723,91096,373,200,NTB,nũ tô falando um nome específico não,90513,91807,1694
91820,92300,480,200,GE-Phrase,232,91461,93385,2324
91820,92300,480,200,NTB,dando <um exemplo>,92060,92852,1192
137959,138132,173,200,GE-Phrase,233,137568,138392,1224
137959,138132,173,200,NTB,e continua reproduzindo,137618,138505,1287
138392,138993,601,200,GE-Phrase,234,138392,139746,1754
138392,138993,601,200,NTB,que é mais burro ainda,138505,139374,1269
142010,143130,1120,200,GE-Phrase,235,141650,143730,2480
142010,143130,1120,200,NTB,queimando floresta,141963,142950,1387
142010,143130,1120,200,NTB,matando índio,142950,143993,1443
44631,45605,974,200,GE-Phrase,201,43285,46196,3311
44631,45605,974,200,NTB,o que é esperado deles,44405,45843,1838
47482,50132,2650,200,GE-Phrase,202,46196,50278,4482
47482,50132,2650,200,GE-Phrase,203,50278,51271,1393
47482,50132,2650,200,NTB,a escrita dele,48982,50259,1677
47482,50132,2650,200,NTB,o que que é esperado,50259,51271,1412
50744,51271,527,200,GE-Phrase,203,50278,51271,1393
50744,51271,527,200,GE-Phrase,204,51271,53518,2647
50744,51271,527,200,NTB,o que que é esperado,50259,51271,1412
50744,51271,527,200,NTB,quais são as fases disso,51271,52642,1771
51271,52394,1123,200,GE-Phrase,204,51271,53518,2647
51271,52394,1123,200,NTB,quais são as fases disso,51271,52642,1771
54284,54753,469,200,GE-Phrase,205,53518,55040,1922
54284,54753,469,200,NTB,qual tipos de línguas,53942,54947,1405
54284,54753,469,200,NTB,vamos ler aqui o',54947,55821,1274
55792,58003,2211,200,GE-Phrase,206,55040,58003,3363
55792,58003,2211,200,GE-Phrase,207,58003,59925,2322
55792,58003,2211,200,NTB,que que cês acharam dessas frases,56890,58110,1620
55792,58003,2211,200,NTB,vamo tentar,58110,59074,1364
58322,59925,1603,200,GE-Phrase,207,58003,59925,2322
58322,59925,1603,200,GE-Phrase,208,59925,61026,1501
58322,59925,1603,200,NTB,discutir elas,59074,59981,1307
58322,59925,1603,200,NTB,como são as construções,59981,61771,2190
59925,61026,1101,200,GE-Phrase,208,59925,61026,1501
59925,61026,1101,200,GE-Phrase,209,61026,62083,1457
59925,61026,1101,200,NTB,como são as construções,59981,61771,2190
61425,62083,658,200,GE-Phrase,209,61026,62083,1457
61425,62083,658,200,GE-Phrase,210,62083,63623,1940
61425,62083,658,200,NTB,tentar ver se eles tão conseguindo pegar o sentido,61771,63790,2419
62698,63623,925,200,GE-Phrase,210,62083,63623,1940
62698,63623,925,200,GE-Phrase,211,63623,66401,3178
62698,63623,925,200,NTB,tentar ver se eles tão conseguindo pegar o sentido,61771,63790,2419
62698,63623,925,200,NTB,e tal,63790,64155,765
64705,65766,1061,200,GE-Phrase,211,63623,66401,3178
64705,65766,1061,200,NTB,é um passo a passo,64831,66124,1693
66401,67067,666,200,GE-Phrase,212,66401,68193,2192
66401,67067,666,200,NTB,tipo,66498,66888,790
66401,67067,666,200,NTB,porque não é uma coisa direta assim,66888,68043,1555
68193,69230,1037,200,GE-Phrase,213,68193,69655,1862
68193,69230,1037,200,NTB,escreva assim,68208,69184,1376
68193,69230,1037,200,NTB,nũ é assim,69184,69893,1109
69955,70863,908,200,GE-Phrase,214,69655,70863,1608
69955,70863,908,200,GE-Phrase,215,70863,72000,1537
69955,70863,908,200,NTB,é uma coisa que cê vai,70203,71406,1603
71163,72000,837,200,GE-Phrase,215,70863,72000,1537
71163,72000,837,200,GE-Phrase,216,72000,73608,2008
71163,72000,837,200,NTB,construindo,71406,71934,928
71163,72000,837,200,NTB,cê vai entendendo,71934,73731,2197
72000,73157,1157,200,GE-Phrase,216,72000,73608,2008
72000,73157,1157,200,NTB,cê vai entendendo,71934,73731,2197
74399,76198,1799,200,GE-Phrase,217,73608,76500,3292
74399,76198,1799,200,NTB,coisas que nũ soam tão &um [/1],75149,76387,1638
74399,76198,1799,200,NTB,&a [/1],76387,76633,646
76500,76849,349,200,GE-Phrase,218,76500,76849,749
76500,76849,349,200,NTB,tendeu,76633,76873,640
80988,82104,1116,200,GE-Phrase,219,79726,83210,3884
80988,82104,1116,200,NTB,a ideia é tipo você quebrar isso em [/1],80088,82648,2960
84794,85160,366,200,GE-Phrase,220,84115,87494,3779
84794,85160,366,200,NTB,compreensão,84712,85912,1600
87494,88651,1157,200,GE-Phrase,221,87494,88651,1557
87494,88651,1157,200,GE-Phrase,222,88651,89435,1184
87494,88651,1157,200,NTB,discussão,87743,88708,1365
87494,88651,1157,200,NTB,e reprodução,88708,89733,1425
88651,89435,784,200,GE-Phrase,222,88651,89435,1184
88651,89435,784,200,GE-Phrase,223,89435,91263,2228
88651,89435,784,200,NTB,e reprodução,88708,89733,1425
89435,90262,827,200,GE-Phrase,223,89435,91263,2228
89435,90262,827,200,NTB,basicamente,89733,90527,1194
94886,96186,1300,200,GE-Phrase,224,94242,96652,2810
94886,96186,1300,200,NTB,dois drafts,95603,96958,1755
100023,101601,1578,200,GE-Phrase,225,99263,101601,2738
100023,101601,1578,200,GE-Phrase,226,101601,103369,2168
100023,101601,1578,200,NTB,eu faço &geral [/1],100723,101430,1107
100023,101601,1578,200,NTB,&he,101430,101775,745
100023,101601,1578,200,NTB,aí acho que a Elisa faz assim também,101775,103364,1989
101601,102234,633,200,GE-Phrase,226,101601,103369,2168
101601,102234,633,200,NTB,aí acho que a Elisa faz assim também,101775,103364,1989
103369,103770,401,200,GE-Phrase,227,103369,104184,1215
103369,103770,401,200,NTB,duas aulas,103364,104271,1307
104584,104918,334,200,GE-Phrase,228,104184,105764,1980
104584,104918,334,200,NTB,uma aula,104500,105269,1169
105764,107960,2196,200,GE-Phrase,229,105764,107960,2596
105764,107960,2196,200,GE-Phrase,230,107960,110406,2846
105764,107960,2196,200,NTB,o que é um statement of purpose,106867,108194,1727
107960,110406,2446,200,GE-Phrase,230,107960,110406,2846
107960,110406,2446,200,GE-Phrase,231,110406,111344,1338
107960,110406,2446,200,NTB,exemplos,109369,110382,1413
107960,110406,2446,200,NTB,pra que que é [/4],110382,111370,1388
110406,111344,938,200,GE-Phrase,231,110406,111344,1338
110406,111344,938,200,GE-Phrase,232,111344,112091,1147
110406,111344,938,200,NTB,pra que que é [/4],110382,111370,1388
110406,111344,938,200,NTB,pra que que aquilo é usado,111370,113448,2478
111344,112091,747,200,GE-Phrase,232,111344,112091,1147
111344,112091,747,200,GE-Phrase,233,112091,112627,936
111344,112091,747,200,NTB,pra que que aquilo é usado,111370,113448,2478
112091,112627,536,200,GE-Phrase,233,112091,112627,936
112091,112627,536,200,GE-Phrase,234,112627,113705,1478
112091,112627,536,200,NTB,pra que que aquilo é usado,111370,113448,2478
113297,113705,408,200,GE-Phrase,234,112627,113705,1478
113297,113705,408,200,GE-Phrase,235,113705,116309,3004
113297,113705,408,200,NTB,e vê um exemplo de um texto de statement of purpose,113448,115859,2811
114029,114639,610,200,GE-Phrase,235,113705,116309,3004
114029,114639,610,200,NTB,e vê um exemplo de um texto de statement of purpose,113448,115859,2811
116693,117316,623,200,GE-Phrase,236,116309,117316,1407
116693,117316,623,200,GE-Phrase,237,117316,119130,2214
116693,117316,623,200,NTB,<discute a partir> daquele,116340,117593,1653
117916,118895,979,200,GE-Phrase,237,117316,119130,2214
117916,118895,979,200,NTB,segunda aula também,117974,119138,1564
119432,119946,514,200,GE-Phrase,238,119130,119946,1216
119432,119946,514,200,GE-Phrase,239,119946,121040,1494
119432,119946,514,200,NTB,vê um texto,119138,119876,1138
119432,119946,514,200,NTB,e disseca ele,119876,120820,1344
120181,120781,600,200,GE-Phrase,239,119946,121040,1494
120181,120781,600,200,NTB,e disseca ele,119876,120820,1344
120181,120781,600,200,NTB,sabe,120820,121144,724
121354,121878,524,200,GE-Phrase,240,121040,121878,1238
121354,121878,524,200,GE-Phrase,241,121878,125705,4227
121354,121878,524,200,NTB,tipo,121144,121940,1196
121354,121878,524,200,NTB,vê as &par [/1],121940,122922,1382
122442,125705,3263,200,GE-Phrase,241,121878,125705,4227
122442,125705,3263,200,GE-Phrase,242,125705,127850,2545
122442,125705,3263,200,NTB,e tal,125198,125513,715
122442,125705,3263,200,NTB,aí fala,125513,125980,867
126365,127379,1014,200,GE-Phrase,242,125705,127850,2545
126365,127379,1014,200,NTB,agora você vai fazer o statement of purpose,125980,127823,2243
128237,128749,512,200,GE-Phrase,243,127850,129473,2023
128237,128749,512,200,NTB,faz o first draft +,128259,129412,1553
130308,131437,1129,200,GE-Phrase,244,129473,132311,3238
130308,131437,1129,200,NTB,cê vê primeiro a estrutura,130180,132230,2450
133011,134284,1273,200,GE-Phrase,245,132311,134865,2954
133011,134284,1273,200,NTB,do mais abrangente pro menos abrangente,132837,134624,2187
135806,137083,1277,200,GE-Phrase,246,134865,137083,2618
135806,137083,1277,200,GE-Phrase,247,137083,138775,2092
135806,137083,1277,200,NTB,primeiro cês viram a estrutura,135857,137069,1612
135806,137083,1277,200,NTB,então tentem reproduzir a estrutura,137069,138608,1939
137516,138318,802,200,GE-Phrase,247,137083,138775,2092
137516,138318,802,200,NTB,então tentem reproduzir a estrutura,137069,138608,1939
138775,139626,851,200,GE-Phrase,248,138775,139626,1251
138775,139626,851,200,GE-Phrase,249,139626,140827,1601
138775,139626,851,200,NTB,agora,139010,139630,1020
138775,139626,851,200,NTB,cês vão me mandar,139630,140668,1438
139626,140595,969,200,GE-Phrase,249,139626,140827,1601
139626,140595,969,200,NTB,cês vão me mandar,139630,140668,1438
139626,140595,969,200,NTB,e eu vou,140668,141300,1032
141843,142545,702,200,GE-Phrase,250,140827,143453,3026
141843,142545,702,200,NTB,pra dentro do seu texto,142049,143133,1484
144186,144811,625,200,GE-Phrase,251,143453,144811,1758
144186,144811,625,200,GE-Phrase,252,144811,145384,973
144186,144811,625,200,NTB,o que que a gente melhorar,144211,145463,1652
144811,145384,573,200,GE-Phrase,252,144811,145384,973
144811,145384,573,200,GE-Phrase,253,145384,150461,5477
144811,145384,573,200,NTB,o que que a gente melhorar,144211,145463,1652
144811,145384,573,200,NTB,nessas frases,145463,146445,1382
145702,149873,4171,200,GE-Phrase,253,145384,150461,5477
145702,149873,4171,200,NTB,o que que tá muito português,148829,150179,1750
151007,152765,1758,200,GE-Phrase,254,150461,153224,3163
151007,152765,1758,200,NTB,e' manda de volta,151697,152875,1578
151007,152765,1758,200,NTB,né,152875,153346,871
153224,154190,966,200,GE-Phrase,255,153224,154757,1933
153224,154190,966,200,NTB,e eles tentam mandar,153346,154881,1935
157557,157877,320,200,GE-Phrase,256,156947,158316,1769
157557,157877,320,200,NTB,seria melhor até que se tivesse mais um draft,156262,158049,2187
157557,157877,320,200,NTB,sabe,158049,158431,782
158758,159358,600,200,GE-Phrase,257,158316,159967,2051
600,1160,560,200,GE-Phrase,201,0,2350,2750
600,1160,560,200,NTB,olha que sorte que eu tive,784,1953,1569
10681,11709,1028,200,GE-Phrase,204,10681,11709,1428
10681,11709,1028,200,GE-Phrase,205,11709,12745,1436
10681,11709,1028,200,NTB,isso é coisa boa,10765,11888,1523
10681,11709,1028,200,NTB,ela foi promovida,11888,12998,1510
11709,12745,1036,200,GE-Phrase,205,11709,12745,1436
11709,12745,1036,200,GE-Phrase,206,12745,15828,3483
11709,12745,1036,200,NTB,ela foi promovida,11888,12998,1510
12745,14308,1563,200,GE-Phrase,206,12745,15828,3483
12745,14308,1563,200,NTB,e aí ela começou a [/1],12998,14587,1989
16148,17061,913,200,GE-Phrase,207,15828,17061,1633
16148,17061,913,200,GE-Phrase,208,17061,19196,2535
16148,17061,913,200,NTB,começou a ganhar mais,15964,17041,1477
16148,17061,913,200,NTB,e ela começou a ganhar mais que meu pai também,17041,19014,2373
17061,18579,1518,200,GE-Phrase,208,17061,19196,2535
17061,18579,1518,200,NTB,e ela começou a ganhar mais que meu pai também,17041,19014,2373
23133,23986,853,200,GE-Phrase,209,23133,25933,3200
23133,23986,853,200,NTB,já o tempo que eu tô fora de casa,22557,25674,3517
26485,27493,1008,200,GE-Phrase,210,25933,27493,1960
26485,27493,1008,200,GE-Phrase,211,27493,29702,2609
26485,27493,1008,200,NTB,também por causa disso,26022,27563,1941
26485,27493,1008,200,NTB,de o salário dele não ser mais a [/1],27563,29529,2366
27493,28197,704,200,GE-Phrase,211,27493,29702,2609
27493,28197,704,200,NTB,de o salário dele não ser mais a [/1],27563,29529,2366
31886,32366,480,200,GE-Phrase,212,31566,32366,1200
31886,32366,480,200,GE-Phrase,213,32366,34665,2699
31886,32366,480,200,NTB,nũ entendi muito bem quando eles me [/1],31755,33285,1930
32790,33932,1142,200,GE-Phrase,213,32366,34665,2699
32790,33932,1142,200,NTB,me explicaram,33285,34491,1606
34665,35145,480,200,GE-Phrase,214,34665,35637,1372
34665,35145,480,200,NTB,mas algo assim,34491,35254,1163
36814,37938,1124,200,GE-Phrase,215,35637,38692,3455
36814,37938,1124,200,NTB,isso fez com que eu não fosse mais dependente do meu pai,36443,38901,2858
39460,40198,738,200,GE-Phrase,216,38692,40783,2491
39460,40198,738,200,NTB,no ano passado,39682,40532,1250
41183,41503,320,200,GE-Phrase,217,40783,41811,1428
41183,41503,320,200,NTB,aí minha mãe me ligou,41039,42329,1690
42630,43055,425,200,GE-Phrase,218,41811,44649,3238
42630,43055,425,200,NTB,e falou olha,42329,42953,1024
42630,43055,425,200,NTB,&he &s [/1],42953,44028,1475
45632,46266,634,200,GE-Phrase,219,44649,47269,3020
45632,46266,634,200,NTB,cê não tem mais dependência do seu pai agora,45402,47445,2443
48014,49804,1790,200,GE-Phrase,220,47269,49804,2935
48014,49804,1790,200,GE-Phrase,221,49804,51662,2258
48014,49804,1790,200,NTB,que,49490,50217,1127
50351,51136,785,200,GE-Phrase,221,49804,51662,2258
50351,51136,785,200,NTB,o trabalho dele oferece,50217,51572,1755
52379,53217,838,200,GE-Phrase,222,51662,55065,3803
52379,53217,838,200,NTB,a gente vai ter que procurar outro plano de saúde,52345,54476,2531
61609,62322,713,200,GE-Phrase,223,61143,62322,1579
61609,62322,713,200,GE-Phrase,224,62322,63789,1867
61609,62322,713,200,NTB,pra quando,61939,62628,1089
62322,63055,733,200,GE-Phrase,224,62322,63789,1867
62322,63055,733,200,NTB,cê tiver alguma coisa,62628,63778,1550
63789,64277,488,200,GE-Phrase,225,63789,64734,1345
63789,64277,488,200,NTB,você vem pra cá,63778,65033,1655
65047,65779,732,200,GE-Phrase,226,64734,66622,2288
65047,65779,732,200,NTB,ou quer fazer aí,65263,66249,1386
66622,66991,369,200,GE-Phrase,227,66622,70088,3866
66622,66991,369,200,NTB,pensei,66641,67102,861
66622,66991,369,200,NTB,falei acho,67102,67514,812
72665,74619,1954,200,GE-Phrase,228,72112,75445,3733
72665,74619,1954,200,NTB,Carnaval,73975,74796,1221
72665,74619,1954,200,NTB,porque,74796,75817,1421
76355,76666,311,200,GE-Phrase,229,75445,76666,1621
76355,76666,311,200,GE-Phrase,230,76666,77782,1516
76355,76666,311,200,NTB,tinha Carnaval,75817,76679,1262
76355,76666,311,200,NTB,aí nũ dá pra ver isso no Carnaval,76679,78053,1774
76746,77538,792,200,GE-Phrase,230,76666,77782,1516
76746,77538,792,200,NTB,aí nũ dá pra ver isso no Carnaval,76679,78053,1774
77782,78471,689,200,GE-Phrase,231,77782,80361,2979
77782,78471,689,200,NTB,nũ dá pra ver isso,78053,79895,2242
85578,86171,593,200,GE-Phrase,232,85578,87969,2791
85578,86171,593,200,NTB,aí tum,85234,85979,1145
85578,86171,593,200,NTB,hérnia,85979,86506,927
91368,91784,416,200,GE-Phrase,233,91106,92493,1787
91368,91784,416,200,NTB,e aí,91250,92348,1498
97699,99143,1444,200,GE-Phrase,234,97206,100372,3566
97699,99143,1444,200,NTB,caraca ele nũ tem plano agora,97535,99953,2818
104141,105648,1507,200,GE-Phrase,235,102686,107303,5017
104141,105648,1507,200,NTB,foi muito bom tipo,105278,106627,1749
108397,109081,684,200,GE-Phrase,236,107303,109081,2178
108397,109081,684,200,GE-Phrase,237,109081,109991,1310
108397,109081,684,200,NTB,aí eu voltei lá pra [/1],108188,109699,1911
109081,109991,910,200,GE-Phrase,237,109081,109991,1310
109081,109991,910,200,GE-Phrase,238,109991,111631,2040
109081,109991,910,200,NTB,pra minha cidade,109699,110335,1036
110491,111061,570,200,GE-Phrase,238,109991,111631,2040
110491,111061,570,200,NTB,e aí eu comecei a passar nos médicos do SUS,110335,113134,3199
112044,112727,683,200,GE-Phrase,239,111631,113339,2108
112044,112727,683,200,NTB,e aí eu comecei a passar nos médicos do SUS,110335,113134,3199
113339,114490,1151,200,GE-Phrase,240,113339,116596,3657
113339,114490,1151,200,NTB,eu fui,114223,115156,1333
116596,117920,1324,200,GE-Phrase,241,116596,118636,2440
116596,117920,1324,200,NTB,que eu fiz,117077,118337,1660
122293,122865,572,200,GE-Phrase,242,121769,123750,2381
122293,122865,572,200,NTB,e aí eu fui em vários médicos pra,121573,124169,2996
129073,131306,2233,200,GE-Phrase,243,128206,131306,3500
129073,131306,2233,200,NTB,que meu caso era sério,130079,131307,1628
786,1695,909,200,GE-Phrase,201,258,1695,1837
786,1695,909,200,GE-Phrase,202,1695,5261,3966
786,1695,909,200,NTB,e aí tem o projeto detalhado,0,1635,2035
786,1695,909,200,NTB,que é onde você faz os cálculos mais de engenharia,1635,3936,2701
2557,4292,1735,200,GE-Phrase,202,1695,5261,3966
2557,4292,1735,200,NTB,mesmo,3936,4993,1457
6655,7722,1067,200,GE-Phrase,203,5261,8664,3803
6655,7722,1067,200,NTB,cê vê uma coisa aerodinâmica mais,7466,9883,2817
9704,10705,1001,200,GE-Phrase,204,8664,11402,3138
9704,10705,1001,200,NTB,detalhada,9883,10694,1211
9704,10705,1001,200,NTB,e tal,10694,11246,952
15773,16407,634,200,GE-Phrase,205,14806,22678,8272
15773,16407,634,200,NTB,só que aí normalmente a gente tem que estender ao máximo o anteprojeto,14726,18122,3796
23045,23578,533,200,GE-Phrase,206,22678,24234,1956
23045,23578,533,200,NTB,consegue uma coisa melhor,22614,24066,1852
24500,25034,534,200,GE-Phrase,207,24234,26587,2753
24500,25034,534,200,NTB,no anteprojeto,24066,25382,1716
27221,28154,933,200,GE-Phrase,208,26587,29024,2837
27221,28154,933,200,NTB,benefício no final das contas é muito maior,26587,28404,2217
29318,30251,933,200,GE-Phrase,209,29024,30453,1829
29318,30251,933,200,NTB,porque mudar as coisas depois do anteprojeto é muito mais difícil,29130,31483,2753
30453,30987,534,200,GE-Phrase,210,30453,32756,2703
30453,30987,534,200,NTB,porque mudar as coisas depois do anteprojeto é muito mais difícil,29130,31483,2753
33792,34358,566,200,GE-Phrase,211,33507,35358,2251
33792,34358,566,200,NTB,o custo é,33648,34712,1464
35995,36728,733,200,GE-Phrase,212,35358,37130,2172
35995,36728,733,200,NTB,<falando isso em &g> [/2],35901,36747,1246
35995,36728,733,200,NTB,em termos de a [/1],36747,37108,761
39239,40340,1101,200,GE-Phrase,213,38622,41036,2814
39239,40340,1101,200,NTB,assim,40016,40391,775
39239,40340,1101,200,NTB,no final das contas hhh,40391,41266,1275
50413,50747,334,200,GE-Phrase,214,49516,51760,2644
50413,50747,334,200,NTB,se você tem um avião lá,49741,51380,2039
52966,53582,616,200,GE-Phrase,215,52378,53582,1604
52966,53582,616,200,GE-Phrase,216,53582,55190,2008
52966,53582,616,200,NTB,aí eu comecei &a [/1],53249,54343,1494
53972,54796,824,200,GE-Phrase,216,53582,55190,2008
53972,54796,824,200,NTB,cálculo estrutural,54343,55214,1271
55414,55754,340,200,GE-Phrase,217,55190,55949,1159
55414,55754,340,200,GE-Phrase,218,55949,57977,2428
55414,55754,340,200,NTB,e o cálculo estrutural já depende geometria,55214,57143,2329
56479,57312,833,200,GE-Phrase,218,55949,57977,2428
56479,57312,833,200,NTB,e o cálculo estrutural já depende geometria,55214,57143,2329
56479,57312,833,200,NTB,depende de tudo,57143,57849,1106
58621,59021,400,200,GE-Phrase,219,57977,59440,1863
58621,59021,400,200,NTB,aí vem o cara lá do anteprojeto,58201,59518,1717
59608,59973,365,200,GE-Phrase,220,59440,59973,933
59608,59973,365,200,GE-Phrase,221,59973,62901,3328
59608,59973,365,200,NTB,não,59518,59868,750
59608,59973,365,200,NTB,vamo ter que aumentar,59868,61292,1824
61305,62453,1148,200,GE-Phrase,221,59973,62901,3328
61305,62453,1148,200,NTB,trinta centímetros da asa,61292,62612,1720
64568,66234,1666,200,GE-Phrase,222,62901,66856,4355
67355,68586,1231,200,GE-Phrase,223,66856,69432,2976
67355,68586,1231,200,NTB,desgraça entendeu,68239,69144,1305
69432,70051,619,200,GE-Phrase,224,69432,70574,1542
69432,70051,619,200,NTB,eu nũ vou fazer isso de novo,69144,70181,1437
71689,72289,600,200,GE-Phrase,225,70574,72859,2685
71689,72289,600,200,NTB,esse é o problema da coisa entendeu,71434,72924,1890
76709,77480,771,200,GE-Phrase,226,75818,77480,2062
76709,77480,771,200,GE-Phrase,227,77480,78739,1659
76709,77480,771,200,NTB,sem fazer o projeto [/1],77016,78670,2054
77480,78353,873,200,GE-Phrase,227,77480,78739,1659
77480,78353,873,200,NTB,sem fazer o projeto [/1],77016,78670,2054
78739,79601,862,200,GE-Phrase,228,78739,80038,1699
78739,79601,862,200,NTB,projeto,78670,80109,1839
80371,80702,331,200,GE-Phrase,229,80038,81632,1994
80371,80702,331,200,NTB,detalhado,80109,80651,942
80371,80702,331,200,NTB,né /,80651,81026,775
82053,82703,650,200,GE-Phrase,230,81632,82920,1688
82053,82703,650,200,NTB,o mais tempo possível,81779,83284,1905
84210,84544,334,200,GE-Phrase,231,82920,84544,2024
84210,84544,334,200,GE-Phrase,232,84544,85300,1156
84210,84544,334,200,NTB,pra tentar tirar o melhor avião possível &d [/1],83284,85329,2445
84544,85300,756,200,GE-Phrase,232,84544,85300,1156
84544,85300,756,200,GE-Phrase,233,85300,86352,1452
84544,85300,756,200,NTB,pra tentar tirar o melhor avião possível &d [/1],83284,85329,2445
84544,85300,756,200,NTB,da [/1],85329,85824,895
85900,86352,452,200,GE-Phrase,233,85300,86352,1452
85900,86352,452,200,GE-Phrase,234,86352,87587,1635
85900,86352,452,200,NTB,que roda umas otimizações lá,85824,88041,2617
86779,87587,808,200,GE-Phrase,234,86352,87587,1635
86779,87587,808,200,GE-Phrase,235,87587,88868,1681
86779,87587,808,200,NTB,que roda umas otimizações lá,85824,88041,2617
88111,88480,369,200,GE-Phrase,235,87587,88868,1681
88111,88480,369,200,NTB,umas viagem,88041,89282,1641
92027,92778,751,200,GE-Phrase,236,91524,93287,2163
92027,92778,751,200,NTB,por isso que demora tanto,91550,92684,1534
92027,92778,751,200,NTB,e aí,92684,93078,794
94521,95832,1311,200,GE-Phrase,237,93287,97522,4635
94521,95832,1311,200,NTB,tipo daí tem um mês pra fazer o projeto detalhado inteiro,94142,97359,3617
97522,98230,708,200,GE-Phrase,238,97522,99461,2339
97522,98230,708,200,NTB,construir um avião oficial,97359,98828,1869
100037,101131,1094,200,GE-Phrase,239,99461,102171,3110
100037,101131,1094,200,NTB,realmente o avião que a gente vai voar,100294,101506,1612
102490,102813,323,200,GE-Phrase,240,102171,104002,2231
102490,102813,323,200,NTB,fazer ensaio nele,102256,103393,1537
112566,113292,726,200,GE-Phrase,241,111522,113521,2399
112566,113292,726,200,NTB,que é aquelas coisa que fica mexendo e,112081,113696,2015
113978,114582,604,200,GE-Phrase,242,113521,115411,2290
113978,114582,604,200,NTB,que tem várias corzinhas,113696,114860,1564
2772,9088,6316,200,GE-Phrase,201,2608,9088,6880
2772,9088,6316,200,GE-Phrase,202,9088,10347,1659
2772,9088,6316,200,NTB,virou,7444,9404,2360
9568,10128,560,200,GE-Phrase,202,9088,10347,1659
9568,10128,560,200,NTB,a Status,9404,10345,1341
10667,11194,527,200,GE-Phrase,203,10347,12187,2240
10667,11194,527,200,NTB,Status foi por muito tempo,10345,12203,2258
12827,13507,680,200,GE-Phrase,204,12187,14987,3200
12827,13507,680,200,NTB,tipo um centro ali na [/1],12592,13870,1678
17277,18017,740,200,GE-Phrase,205,16652,18017,1765
17277,18017,740,200,GE-Phrase,206,18017,22757,5140
17277,18017,740,200,NTB,quando você veio pra cá,16715,18080,1765
17277,18017,740,200,NTB,eles já tinham fechado ali tudo na praça da Savassi né //,18080,20601,2921
18497,20037,1540,200,GE-Phrase,206,18017,22757,5140
18497,20037,1540,200,NTB,eles já tinham fechado ali tudo na praça da Savassi né //,18080,20601,2921
31993,32742,749,200,GE-Phrase,207,30475,33515,3440
31993,32742,749,200,NTB,a agência Status assim,31904,33622,2118
34142,35491,1349,200,GE-Phrase,208,33515,35835,2720
34142,35491,1349,200,NTB,ela foi parte,33622,35306,2084
34142,35491,1349,200,NTB,sabe,35306,35953,1047
35835,37108,1273,200,GE-Phrase,209,35835,38235,2800
35835,37108,1273,200,NTB,de muita gente,36783,37971,1588
38615,39488,873,200,GE-Phrase,210,38235,40635,2800
38615,39488,873,200,NTB,virou Café Status,38286,40078,2192
41029,42087,1058,200,GE-Phrase,211,40635,42555,2320
41029,42087,1058,200,NTB,eu comecei a dar aula pro Gustavo,40934,43434,2900
43681,44506,825,200,GE-Phrase,212,42555,45475,3320
43681,44506,825,200,NTB,nessa escola de inglês +,43434,44780,1746
46947,47595,648,200,GE-Phrase,213,46515,47595,1480
46947,47595,648,200,GE-Phrase,214,47595,50235,3040
46947,47595,648,200,NTB,esse Gustavo,46572,47773,1601
46947,47595,648,200,NTB,&he,47773,48556,1183
48675,49209,534,200,GE-Phrase,214,47595,50235,3040
48675,49209,534,200,NTB,esse meu [/1],48556,49370,1214
48675,49209,534,200,NTB,meu aluno,49370,50051,1081
55119,55997,878,200,GE-Phrase,215,54565,55997,1832
55119,55997,878,200,GE-Phrase,216,55997,57367,1770
55119,55997,878,200,NTB,tipo cê dá aula por fora,54643,56227,1984
56247,56756,509,200,GE-Phrase,216,55997,57367,1770
56247,56756,509,200,NTB,eu falei dou,56227,57050,1223
58061,58501,440,200,GE-Phrase,217,57367,58501,1534
58061,58501,440,200,GE-Phrase,218,58501,59087,986
58061,58501,440,200,NTB,eu gostaria de ter aula [/5],57832,58837,1405
58821,59087,266,200,GE-Phrase,218,58501,59087,986
58821,59087,266,200,GE-Phrase,219,59087,59727,1040
58821,59087,266,200,NTB,gostei de ter aula com você e tudo,58837,60272,1835
59247,59407,160,200,GE-Phrase,219,59087,59727,1040
59247,59407,160,200,NTB,gostei de ter aula com você e tudo,58837,60272,1835
60397,60927,530,200,GE-Phrase,220,59727,60927,1600
60397,60927,530,200,GE-Phrase,221,60927,63287,2760
60397,60927,530,200,NTB,gostaria de ter aula com você,60272,61330,1458
61831,63287,1456,200,GE-Phrase,221,60927,63287,2760
61831,63287,1456,200,GE-Phrase,222,63287,64327,1440
61831,63287,1456,200,NTB,cê pode me dar aula na Status,61499,63128,2029
61831,63287,1456,200,NTB,aí eu falei,63128,63798,1070
63767,64327,560,200,GE-Phrase,222,63287,64327,1440
63767,64327,560,200,GE-Phrase,223,64327,65287,1360
63767,64327,560,200,NTB,posso,63798,64320,922
63767,64327,560,200,NTB,tipo é super tranquilo,64320,65270,1350
64607,64927,320,200,GE-Phrase,223,64327,65287,1360
64607,64927,320,200,NTB,tipo é super tranquilo,64320,65270,1350
65527,66007,480,200,GE-Phrase,224,65287,66967,2080
65527,66007,480,200,NTB,era mais perto inclusive do que a [/1],65270,66759,1889
74950,75616,666,200,GE-Phrase,225,74390,76279,2289
74950,75616,666,200,NTB,a Status que eu ia,74495,76336,2241
76512,76980,468,200,GE-Phrase,226,76279,77639,1760
76512,76980,468,200,NTB,que era só um corredorzinho,76336,77920,1984
77999,78319,320,200,GE-Phrase,227,77639,79279,2040
77999,78319,320,200,NTB,que depois virou,77920,79367,1847
79501,79868,367,200,GE-Phrase,228,79279,80954,2075
79501,79868,367,200,NTB,né,79367,79692,725
79501,79868,367,200,NTB,um negócio enorme,79692,81357,2065
81451,81891,440,200,GE-Phrase,229,80954,82638,2084
81451,81891,440,200,NTB,era um [/1],81357,82056,1099
81451,81891,440,200,NTB,um [/1],82056,82511,855
98286,98526,240,200,GE-Phrase,230,97846,98708,1262
98286,98526,240,200,GE-Phrase,231,98708,100412,2104
98286,98526,240,200,NTB,do aluno,98199,98848,1049
98708,99217,509,200,GE-Phrase,231,98708,100412,2104
98708,99217,509,200,NTB,da interação que cê tem com aluno,98848,100935,2487
116319,116792,473,200,GE-Phrase,232,115758,117322,1964
116319,116792,473,200,NTB,ainda vou né,116021,117131,1510
131479,132039,560,200,GE-Phrase,233,130801,133593,3192
131479,132039,560,200,NTB,que eu pudesse aprender,131417,132728,1711
134473,136803,2330,200,GE-Phrase,234,133993,136803,3210
134473,136803,2330,200,GE-Phrase,235,136803,138001,1598
134473,136803,2330,200,NTB,eu pedia pro meu aluno falar do trabalho dele,134099,137105,3406
136963,137483,520,200,GE-Phrase,235,136803,138001,1598
136963,137483,520,200,NTB,em inglês obviamente,137105,138339,1634
138475,139096,621,200,GE-Phrase,236,138001,139371,1770
138475,139096,621,200,NTB,a gente tinha livro e tudo,138339,139647,1708
140340,143181,2841,200,GE-Phrase,237,139371,143181,4210
140340,143181,2841,200,GE-Phrase,238,143181,145083,2302
140340,143181,2841,200,NTB,do aluno,142082,143110,1428
140340,143181,2841,200,NTB,que isso ia ajudá-lo,143309,144587,1678
143181,143901,720,200,GE-Phrase,238,143181,145083,2302
143181,143901,720,200,NTB,que isso ia ajudá-lo,143309,144587,1678
147434,148267,833,200,GE-Phrase,239,147434,149980,2946
147434,148267,833,200,NTB,ela é a mais arisca,147432,148736,1704
149980,150503,523,200,GE-Phrase,240,149980,151218,1638
149980,150503,523,200,NTB,ela é a Harpinha,150117,150998,1281
151218,151583,365,200,GE-Phrase,241,151218,154074,3256
151218,151583,365,200,NTB,é a primeira,151274,151974,1100
3473,4043,570,200,GE-Phrase,201,2987,4043,1456
3473,4043,570,200,GE-Phrase,202,4043,6740,3097
3473,4043,570,200,NTB,te contar desde o ano novo né,3480,4837,1757
4966,6126,1160,200,GE-Phrase,202,4043,6740,3097
4966,6126,1160,200,NTB,foi uma sequência de coisas,5391,7021,2030
8514,9547,1033,200,GE-Phrase,203,7703,9547,2244
8514,9547,1033,200,GE-Phrase,204,9547,12780,3633
8514,9547,1033,200,NTB,depois daquele rolê,8980,9906,1326
9547,10299,752,200,GE-Phrase,204,9547,12780,3633
9547,10299,752,200,NTB,cheguei a comentar com você que eu tinha perguntado pra ele,9906,12460,2954
12780,13179,399,200,GE-Phrase,205,12780,13614,1234
12780,13179,399,200,NTB,que que a gente &t [/1],12460,13587,1527
15197,15933,736,200,GE-Phrase,206,14778,16398,2020
15197,15933,736,200,NTB,ele parou de falar comigo no Ano-Novo,15089,16711,2022
16398,16860,462,200,GE-Phrase,207,16398,17231,1233
16398,16860,462,200,NTB,ele parou de falar comigo no Ano-Novo,15089,16711,2022
16398,16860,462,200,NTB,tipo assim,16711,17488,1177
17381,18116,735,200,GE-Phrase,208,17231,18613,1782
17381,18116,735,200,NTB,eu tinha mandado uma mensagem pra ele antes de virar o ano,17488,20356,3268
18879,19412,533,200,GE-Phrase,209,18613,20081,1868
18879,19412,533,200,NTB,eu tinha mandado uma mensagem pra ele antes de virar o ano,17488,20356,3268
22933,23366,433,200,GE-Phrase,210,22182,24153,2371
22933,23366,433,200,NTB,nũ mandou nem um feliz Ano-Novo,22619,24045,1826
24534,24856,322,200,GE-Phrase,211,24153,25283,1530
24534,24856,322,200,NTB,nũ mandou nada,24920,25579,1059
25283,25826,543,200,GE-Phrase,212,25283,26449,1566
25283,25826,543,200,NTB,eu,25579,25972,793
25283,25826,543,200,NTB,tá bom,25972,26622,1050
26682,27124,442,200,GE-Phrase,213,26449,27441,1392
26682,27124,442,200,NTB,<aí eu deixei>,26971,27666,1095
31495,31925,430,200,GE-Phrase,214,31036,31925,1289
31495,31925,430,200,NTB,aí ele parou,31141,32268,1527
33731,34268,537,200,GE-Phrase,215,33357,34268,1311
33731,34268,537,200,GE-Phrase,216,34268,35727,1859
33731,34268,537,200,NTB,porque eu fui eu [/1],33723,34774,1451
34566,35333,767,200,GE-Phrase,216,34268,35727,1859
34566,35333,767,200,NTB,a última a perguntar qualquer coisa +,34774,36251,1877
44550,45037,487,200,GE-Phrase,217,44209,45219,1410
44550,45037,487,200,GE-Phrase,218,45219,47221,2402
44550,45037,487,200,NTB,eu fiquei encucada e mandei,44802,45982,1580
45613,46633,1020,200,GE-Phrase,218,45219,47221,2402
45613,46633,1020,200,NTB,mensagem seis dias depois,46213,47453,1640
49529,49973,444,200,GE-Phrase,219,49185,50170,1385
49529,49973,444,200,GE-Phrase,220,50170,51020,1250
49529,49973,444,200,NTB,aí continuou conversando,49322,50730,1808
50260,50783,523,200,GE-Phrase,220,50170,51020,1250
50260,50783,523,200,NTB,aí continuou conversando,49322,50730,1808
50260,50783,523,200,NTB,ele parou de novo,50730,51581,1251
51373,52022,649,200,GE-Phrase,221,51020,53094,2474
51373,52022,649,200,NTB,e daí nessa vez eu desisti mesmo,51581,53120,1939
53850,55066,1216,200,GE-Phrase,222,53094,56433,3739
53850,55066,1216,200,NTB,tipo já entendi que ele não quer,54845,56444,1999
56631,57097,466,200,GE-Phrase,223,56433,58070,2037
56631,57097,466,200,NTB,aí deixei,56947,57846,1299
58849,59433,584,200,GE-Phrase,224,58070,60019,2349
58849,59433,584,200,NTB,mais de um mês sem falar comigo aí encontrei com ele na academia,58947,61986,3439
60642,61088,446,200,GE-Phrase,225,60019,61392,1773
60642,61088,446,200,NTB,mais de um mês sem falar comigo aí encontrei com ele na academia,58947,61986,3439
61691,62699,1008,200,GE-Phrase,226,61392,64369,3377
61691,62699,1008,200,NTB,pandemia acontecer ,62382,63218,1236
64693,65356,663,200,GE-Phrase,227,64369,65566,1597
64693,65356,663,200,NTB,eu tava fazendo exercício e' tava do meu lado só que eu não me aguentei,64980,67373,2793
66200,66669,469,200,GE-Phrase,228,65566,66900,1734
66200,66669,469,200,NTB,eu tava fazendo exercício e' tava do meu lado só que eu não me aguentei,64980,67373,2793
66900,67670,770,200,GE-Phrase,229,66900,68445,1945
66900,67670,770,200,NTB,eu tive que falar alguma coisa,67373,68605,1632
71207,71542,335,200,GE-Phrase,230,70945,72104,1559
71207,71542,335,200,NTB,ele respondeu que e' tava bem ,71332,72534,1602
75999,77003,1004,200,GE-Phrase,231,75468,77678,2610
75999,77003,1004,200,NTB,bem bem chata mesmo,76477,78459,2382
80593,81366,773,200,GE-Phrase,232,79771,82089,2718
80593,81366,773,200,NTB,como se isso importasse,80704,82470,2166
82489,83144,655,200,GE-Phrase,233,82089,84065,2376
82489,83144,655,200,NTB,né,82470,83029,959
87966,88805,839,200,GE-Phrase,234,87258,90062,3204
87966,88805,839,200,NTB,a gente conversou mais um negócio lá,88300,89980,2080
90626,91369,743,200,GE-Phrase,235,90062,91831,2169
90626,91369,743,200,NTB,aí eu fui &em [/1],89980,91265,1685
90626,91369,743,200,NTB,saí,91265,91967,1102
92504,93217,713,200,GE-Phrase,236,91831,93333,1902
92504,93217,713,200,GE-Phrase,237,93333,94899,1966
92504,93217,713,200,NTB,a hora que eu tava indo embora,92990,93892,1302
93706,94140,434,200,GE-Phrase,237,93333,94899,1966
93706,94140,434,200,NTB,eu vi ele mexendo no celular,93892,95283,1791
96556,97599,1043,200,GE-Phrase,238,94899,98304,3805
96556,97599,1043,200,NTB,aí no que ele tava mexendo no celular eu peguei o meu ele tinha mandado mensagem,95744,98213,2869
101064,101966,902,200,GE-Phrase,239,98304,102783,4879
101064,101966,902,200,NTB,você foi a última a mandar mensagem,101297,102970,2073
103036,103303,267,200,GE-Phrase,240,102783,103625,1242
103036,103303,267,200,NTB,eu acho que eu abri e esqueci de responder,102970,105348,2778
105638,105992,354,200,GE-Phrase,241,105023,105992,1369
105638,105992,354,200,GE-Phrase,242,105992,107233,1641
105638,105992,354,200,NTB,aí ele falou bem assim,105348,106469,1521
106195,106491,296,200,GE-Phrase,242,105992,107233,1641
106195,106491,296,200,NTB,aí ele falou bem assim,105348,106469,1521
106195,106491,296,200,NTB,,106469,107716,1647
107466,110658,3192,200,GE-Phrase,243,107233,113333,6500
107466,110658,3192,200,NTB,pra tentar consertar,109747,110999,1652
117153,117595,442,200,GE-Phrase,244,116617,117595,1378
117153,117595,442,200,GE-Phrase,245,117595,120666,3471
117153,117595,442,200,NTB,eu respirei,117149,117889,1140
117926,119980,2054,200,GE-Phrase,245,117595,120666,3471
117926,119980,2054,200,NTB,uma pessoa agradável se eu respondesse,119479,120780,1701
121480,121831,351,200,GE-Phrase,246,120666,122158,1892
121480,121831,351,200,NTB,aí eu fiquei uns [/1],121286,121779,893
121480,121831,351,200,NTB,uns dias sem responder aí <respondi>,121779,123425,2046
122302,122668,366,200,GE-Phrase,247,122158,123368,1610
122302,122668,366,200,NTB,uns dias sem responder aí <respondi>,121779,123425,2046
123632,124086,454,200,GE-Phrase,248,123368,124547,1579
123632,124086,454,200,NTB,ai eu nũ aguentei,124258,125037,1179
126026,126462,436,200,GE-Phrase,249,124547,127723,3576
126026,126462,436,200,NTB,mas aí foi,126391,127419,1428
128017,128638,621,200,GE-Phrase,250,127723,129004,1681
128017,128638,621,200,NTB,conversando ele parou de novo e eu não vou chamar de novo,128240,131160,3320
129237,129866,629,200,GE-Phrase,251,129004,130404,1800
129237,129866,629,200,NTB,conversando ele parou de novo e eu não vou chamar de novo,128240,131160,3320
131184,132799,1615,200,GE-Phrase,252,130404,133766,3762
131184,132799,1615,200,NTB,<sei>,132588,133588,1400
134275,134866,591,200,GE-Phrase,253,133766,135577,2211
134275,134866,591,200,NTB,nũ sei que que o menino quer,134158,135560,1802
137917,138451,534,200,GE-Phrase,254,137516,139540,2424
137917,138451,534,200,NTB,eu voltei a fazer terapia,138040,139167,1527
140821,142191,1370,200,GE-Phrase,255,139540,142191,3051
140821,142191,1370,200,GE-Phrase,256,142191,146166,4375
140821,142191,1370,200,NTB,tinha terminado de fazer minha sessão eu catei o celular e ele,141100,144181,3481
143063,144529,1466,200,GE-Phrase,256,142191,146166,4375
143063,144529,1466,200,NTB,tamo nessa de não se falar de novo,144181,146283,2502
152749,153501,752,200,GE-Phrase,257,152032,153501,1869
152749,153501,752,200,GE-Phrase,258,153501,155679,2578
152749,153501,752,200,NTB,eu tive que esperar uma semana pa poder contar isso pra ela e eu fiquei muito angustiada porque eu falei vei,152816,157395,4979
153501,154819,1318,200,GE-Phrase,258,153501,155679,2578
153501,154819,1318,200,NTB,eu tive que esperar uma semana pa poder contar isso pra ela e eu fiquei muito angustiada porque eu falei vei,152816,157395,4979
22200,23600,1400,200,GE-Phrase,201,21741,26246,4905
22200,23600,1400,200,NTB,tive té algumas experiências como professora,22016,25145,3529
26818,29753,2935,200,GE-Phrase,202,26246,31776,5930
26818,29753,2935,200,NTB,mas como também,28596,29656,1460
26818,29753,2935,200,NTB,&he,29656,30748,1492
32291,32731,440,200,GE-Phrase,203,31776,33450,2074
32291,32731,440,200,NTB,no Espaço Cênico também,32095,33536,1841
33641,34081,440,200,GE-Phrase,204,33450,34467,1417
33641,34081,440,200,NTB,que eu tive a oportunidade de dar [/1],33536,35220,2084
41773,42216,443,200,GE-Phrase,205,40919,42682,2163
41773,42216,443,200,NTB,posso talvez eventualmente no futuro abrir uma escola de teatro e aí eu [/1],41551,47132,5981
43876,44676,800,200,GE-Phrase,206,42682,45633,3351
43876,44676,800,200,NTB,posso talvez eventualmente no futuro abrir uma escola de teatro e aí eu [/1],41551,47132,5981
46548,49633,3085,200,GE-Phrase,207,45633,50262,5029
46548,49633,3085,200,NTB,eu queira trabalhar com pessoas interessadas em teatro,47132,50463,3731
52696,53456,760,200,GE-Phrase,208,50262,54168,4306
52696,53456,760,200,NTB,exatamente,52785,53868,1483
54168,55768,1600,200,GE-Phrase,209,54168,56339,2571
54168,55768,1600,200,NTB,trabalhar com pessoas que queiram ter,54217,56382,2565
56339,58435,2096,200,GE-Phrase,210,56339,59062,3123
56339,58435,2096,200,NTB,dar aulas para pessoas que querem,56382,58608,2626
56339,58435,2096,200,NTB,né,58608,59232,1024
60180,63144,2964,200,GE-Phrase,211,59062,63144,4482
60180,63144,2964,200,GE-Phrase,212,63144,63674,930
60180,63144,2964,200,NTB,de teatro ou querem estar no meio,61006,63269,2663
60180,63144,2964,200,NTB,enfim,63269,63803,934
63144,63674,530,200,GE-Phrase,212,63144,63674,930
63144,63674,530,200,GE-Phrase,213,63674,65469,2195
63144,63674,530,200,NTB,enfim,63269,63803,934
63144,63674,530,200,NTB,qual o rumo delas vai tomar,63803,65422,2019
63674,64625,951,200,GE-Phrase,213,63674,65469,2195
63674,64625,951,200,NTB,qual o rumo delas vai tomar,63803,65422,2019
65727,66647,920,200,GE-Phrase,214,65469,68076,3007
65727,66647,920,200,NTB,isso já não é,65422,66840,1818
65727,66647,920,200,NTB,problema meu,66840,67735,1295
69881,71172,1291,200,GE-Phrase,215,69547,71964,2817
69881,71172,1291,200,NTB,é diferente do que você ter que seguir um plano pedagógico,69723,74144,4821
72585,73344,759,200,GE-Phrase,216,71964,74244,2680
72585,73344,759,200,NTB,é diferente do que você ter que seguir um plano pedagógico,69723,74144,4821
75204,76804,1600,200,GE-Phrase,217,74244,77654,3810
75204,76804,1600,200,NTB,do que você ter que ir num lugar onde os pais forçam seus filhos a estarem,74144,80749,7005
77991,80271,2280,200,GE-Phrase,218,77654,80791,3537
77991,80271,2280,200,NTB,do que você ter que ir num lugar onde os pais forçam seus filhos a estarem,74144,80749,7005
81431,83136,1705,200,GE-Phrase,219,80791,83136,2745
81431,83136,1705,200,GE-Phrase,220,83136,84139,1403
81431,83136,1705,200,NTB,a nova onda agora são crianças serem blogueiras,81757,85973,4616
83136,84139,1003,200,GE-Phrase,220,83136,84139,1403
83136,84139,1003,200,GE-Phrase,221,84139,91180,7441
83136,84139,1003,200,NTB,a nova onda agora são crianças serem blogueiras,81757,85973,4616
84939,88042,3103,200,GE-Phrase,221,84139,91180,7441
97221,98036,815,200,GE-Phrase,222,96160,99128,3368
97221,98036,815,200,NTB,tinha criança que cê via nitidamente que não queria tá lá,96084,99169,3485
101935,103091,1156,200,GE-Phrase,223,101257,103759,2902
101935,103091,1156,200,NTB,cê via nitidamente que a criança não queria tá,101045,103554,2909
105018,106316,1298,200,GE-Phrase,224,103759,109504,6145
105018,106316,1298,200,NTB,a aula de teatro,105095,106208,1513
105018,106316,1298,200,NTB,sabe,106208,106704,896
111054,111811,757,200,GE-Phrase,225,109504,112551,3447
111054,111811,757,200,NTB,não quer,110952,112065,1513
113880,116577,2697,200,GE-Phrase,226,112551,117231,5080
113880,116577,2697,200,NTB,não é real,115595,116602,1407
113880,116577,2697,200,NTB,sabe,116602,117602,1400
117856,118997,1141,200,GE-Phrase,227,117231,119677,2846
117856,118997,1141,200,NTB,é pra suprir desejos,117602,119981,2779
120757,122037,1280,200,GE-Phrase,228,119677,124094,4817
120757,122037,1280,200,NTB,reprimido dos pais que não tiveram,120319,123379,3460
1415,1838,423,200,GE-Phrase,201,775,3090,2715
1415,1838,423,200,NTB,essas pessoas ainda não [/1],837,2050,1613
3689,4649,960,200,GE-Phrase,202,3090,5147,2457
3689,4649,960,200,NTB,eu tô falando de um lugar que,3382,5062,2080
5793,6814,1021,200,GE-Phrase,203,5147,7548,2801
5793,6814,1021,200,NTB,dentro da teó,6341,6928,987
5793,6814,1021,200,NTB,a gente tem muito,6928,7884,1356
8353,8753,400,200,GE-Phrase,204,7548,9104,1956
8353,8753,400,200,NTB,relato de experiência,7884,8935,1451
8353,8753,400,200,NTB,por exemplo,8935,9631,1096
10503,10898,395,200,GE-Phrase,205,9104,11228,2524
10503,10898,395,200,NTB,que inclusive tô produzindo um,9631,12030,2799
11616,12216,600,200,GE-Phrase,206,11228,13092,2264
11616,12216,600,200,NTB,que inclusive tô produzindo um,9631,12030,2799
11616,12216,600,200,NTB,p' cê ver a dubiedade da coisa,12030,13506,1876
13708,14576,868,200,GE-Phrase,207,13092,14908,2216
13708,14576,868,200,NTB,e não é que relato de experiência seja menos ciência,13506,16418,3312
15081,15761,680,200,GE-Phrase,208,14908,16388,1880
15081,15761,680,200,NTB,e não é que relato de experiência seja menos ciência,13506,16418,3312
17273,18214,941,200,GE-Phrase,209,16388,18214,2226
17273,18214,941,200,GE-Phrase,210,18214,21954,4140
17273,18214,941,200,NTB,mas é mais difícil de replicar,16418,18201,2183
18881,20041,1160,200,GE-Phrase,210,18214,21954,4140
18881,20041,1160,200,NTB,procura dentro da ciência de uma dada forma,19439,21320,2281
22725,23109,384,200,GE-Phrase,211,21954,23414,1860
22725,23109,384,200,NTB,então se eu fizer isso aqui c' esse sujeito aqui,21953,23636,2083
23890,25250,1360,200,GE-Phrase,212,23414,26572,3558
23890,25250,1360,200,NTB,eu posso fazer lá na China,23636,25187,1951
23890,25250,1360,200,NTB,se eu reproduzir meu método,25187,26370,1583
27305,28425,1120,200,GE-Phrase,213,26572,28865,2693
27305,28425,1120,200,NTB,e adequando e et cetera,28048,29067,1419
29147,29347,200,200,GE-Phrase,214,28865,30267,1802
29147,29347,200,200,NTB,e vai dar bom,29067,29721,1054
31027,32067,1040,200,GE-Phrase,215,30267,32498,2631
31027,32067,1040,200,NTB,então falta um pouco desse metodismo assim,30583,32769,2586
32498,33005,507,200,GE-Phrase,216,32498,33698,1600
32498,33005,507,200,NTB,talvez [/1],32769,33965,1596
33892,35750,1858,200,GE-Phrase,217,33698,35750,2452
33892,35750,1858,200,GE-Phrase,218,35750,37119,1769
33892,35750,1858,200,NTB,seja da especificidade,34582,35920,1738
33892,35750,1858,200,NTB,né,35920,36331,811
36123,37119,996,200,GE-Phrase,218,35750,37119,1769
36123,37119,996,200,GE-Phrase,219,37119,38166,1447
36123,37119,996,200,NTB,de cada campo dentro da área,36331,37360,1429
37119,37515,396,200,GE-Phrase,219,37119,38166,1447
37119,37515,396,200,NTB,de cada campo dentro da área,36331,37360,1429
37119,37515,396,200,NTB,eu não sei,37360,38258,1298
39080,41856,2776,200,GE-Phrase,220,38166,41856,4090
39080,41856,2776,200,GE-Phrase,221,41856,43989,2533
39080,41856,2776,200,NTB,e que tinha que ser trabalhada,40576,41972,1796
39080,41856,2776,200,NTB,e nũ sei o quê,41972,42354,782
41856,42668,812,200,GE-Phrase,221,41856,43989,2533
41856,42668,812,200,NTB,e eu realmente acho que,42354,43456,1502
45035,46490,1455,200,GE-Phrase,222,43989,47684,4095
45035,46490,1455,200,NTB,,45850,46653,1203
45035,46490,1455,200,NTB,pífia assim,46653,47304,1051
51557,52801,1244,200,GE-Phrase,223,51145,53707,2962
51557,52801,1244,200,NTB,vai por esse viés,52497,53402,1305
56362,57457,1095,200,GE-Phrase,224,53707,59015,5708
56362,57457,1095,200,NTB,e aí ela tinha essa ideia de fazer esse clube,55679,57555,2276
56362,57457,1095,200,NTB,e et cetera,57555,58051,896
60245,60773,528,200,GE-Phrase,225,59015,60773,2158
60245,60773,528,200,GE-Phrase,226,60773,61487,1114
60245,60773,528,200,NTB,e aí sempre ficava na ideia da imaginação,59821,61678,2257
60773,61487,714,200,GE-Phrase,226,60773,61487,1114
60773,61487,714,200,GE-Phrase,227,61487,62271,1184
60773,61487,714,200,NTB,e aí sempre ficava na ideia da imaginação,59821,61678,2257
60773,61487,714,200,NTB,chegou a quarentena,61678,62426,1148
61487,62271,784,200,GE-Phrase,227,61487,62271,1184
61487,62271,784,200,GE-Phrase,228,62271,63151,1280
61487,62271,784,200,NTB,chegou a quarentena,61678,62426,1148
61487,62271,784,200,NTB,ela falou,62426,62814,788
62271,63151,880,200,GE-Phrase,228,62271,63151,1280
62271,63151,880,200,GE-Phrase,229,63151,64941,2190
62271,63151,880,200,NTB,ótimo,62814,63449,1035
64021,64941,920,200,GE-Phrase,229,63151,64941,2190
64021,64941,920,200,GE-Phrase,230,64941,66067,1526
64021,64941,920,200,NTB,disponível pra isso,64387,65316,1329
65429,66067,638,200,GE-Phrase,230,64941,66067,1526
65429,66067,638,200,GE-Phrase,231,66067,67075,1408
65429,66067,638,200,NTB,cê anima entrar nessa,65316,66257,1341
65429,66067,638,200,NTB,eu falei,66257,66429,572
66358,67075,717,200,GE-Phrase,231,66067,67075,1408
66358,67075,717,200,GE-Phrase,232,67075,69124,2449
66358,67075,717,200,NTB,vão bora,66429,66980,951
67722,69124,1402,200,GE-Phrase,232,67075,69124,2449
67722,69124,1402,200,GE-Phrase,233,69124,70078,1354
67722,69124,1402,200,NTB,entrando como coadjuvante,67548,69028,1880
67722,69124,1402,200,NTB,né,69028,69285,657
67722,69124,1402,200,NTB,o projeto é dela,69285,70269,1384
69404,70078,674,200,GE-Phrase,233,69124,70078,1354
69404,70078,674,200,GE-Phrase,234,70078,71694,2016
69404,70078,674,200,NTB,o projeto é dela,69285,70269,1384
69404,70078,674,200,NTB,e aí eu sou esse bonequinho aqui que,70269,72901,3032
70626,71415,789,200,GE-Phrase,234,70078,71694,2016
70626,71415,789,200,NTB,e aí eu sou esse bonequinho aqui que,70269,72901,3032
71694,72912,1218,200,GE-Phrase,235,71694,73762,2468
71694,72912,1218,200,NTB,e aí eu sou esse bonequinho aqui que,70269,72901,3032
71694,72912,1218,200,NTB,vão bora,72901,73414,913
74303,75009,706,200,GE-Phrase,236,73762,75009,1647
74303,75009,706,200,GE-Phrase,237,75009,75819,1210
74303,75009,706,200,NTB,mas assim,74742,75653,1311
75009,75819,810,200,GE-Phrase,237,75009,75819,1210
75009,75819,810,200,GE-Phrase,238,75819,77216,1797
75009,75819,810,200,NTB,mas assim,74742,75653,1311
75009,75819,810,200,NTB,o negócio é dela,75653,76513,1260
75819,76484,665,200,GE-Phrase,238,75819,77216,1797
75819,76484,665,200,NTB,o negócio é dela,75653,76513,1260
75819,76484,665,200,NTB,né,76513,76805,692
78759,81294,2535,200,GE-Phrase,239,78317,81294,3377
78759,81294,2535,200,GE-Phrase,240,81294,83492,2598
78759,81294,2535,200,NTB,toda semana a gente se reunia pelo menos duas vezes por semana,80561,83244,3083
81849,82796,947,200,GE-Phrase,240,81294,83492,2598
81849,82796,947,200,NTB,toda semana a gente se reunia pelo menos duas vezes por semana,80561,83244,3083
84721,87460,2739,200,GE-Phrase,241,83492,88086,4994
84721,87460,2739,200,NTB,e aquela coisinha gostosa assim de movimentação,85110,87543,2833
84721,87460,2739,200,NTB,sabe,87543,87834,691
88086,90150,2064,200,GE-Phrase,242,88086,90150,2464
88086,90150,2064,200,GE-Phrase,243,90150,91779,2029
88086,90150,2064,200,NTB,eu tive a ideia de escrever um artigo,89913,91343,1830
90527,91106,579,200,GE-Phrase,243,90150,91779,2029
90527,91106,579,200,NTB,eu tive a ideia de escrever um artigo,89913,91343,1830
92219,92767,548,200,GE-Phrase,244,91779,92767,1388
92219,92767,548,200,GE-Phrase,245,92767,94054,1687
92219,92767,548,200,NTB,Nossa,92140,92888,1148
92219,92767,548,200,NTB,e é minha amiga lá de São Carlos,92888,94180,1692
93320,94054,734,200,GE-Phrase,245,92767,94054,1687
93320,94054,734,200,GE-Phrase,246,94054,96105,2451
93320,94054,734,200,NTB,e é minha amiga lá de São Carlos,92888,94180,1692
94677,95892,1215,200,GE-Phrase,246,94054,96105,2451
94677,95892,1215,200,NTB,que a gente retomou contato na quarentena assim,94623,96254,2031
96105,97004,899,200,GE-Phrase,247,96105,97925,2220
96105,97004,899,200,NTB,de uma forma mais [/1],96254,97376,1522
101856,102665,809,200,GE-Phrase,248,99999,102665,3066
101856,102665,809,200,GE-Phrase,249,102665,105016,2751
101856,102665,809,200,NTB,vamo fazer esse artigo acontecer,100915,102900,2385
103225,105016,1791,200,GE-Phrase,249,102665,105016,2751
103225,105016,1791,200,GE-Phrase,250,105016,106042,1426
103225,105016,1791,200,NTB,e aí falou pra orientadora dela,104757,106130,1773
105016,106042,1026,200,GE-Phrase,250,105016,106042,1426
105016,106042,1026,200,GE-Phrase,251,106042,107751,2109
105016,106042,1026,200,NTB,e aí falou pra orientadora dela,104757,106130,1773
105016,106042,1026,200,NTB,e aí a gente falou,106130,106712,982
106466,107751,1285,200,GE-Phrase,251,106042,107751,2109
106466,107751,1285,200,GE-Phrase,252,107751,108288,937
106466,107751,1285,200,NTB,é agora,107141,107721,980
106466,107751,1285,200,NTB,esse artigo,107721,108332,1011
107751,108288,537,200,GE-Phrase,252,107751,108288,937
107751,108288,537,200,GE-Phrase,253,108288,109302,1414
107751,108288,537,200,NTB,esse artigo,107721,108332,1011
107751,108288,537,200,NTB,enfim,108332,108795,863
108288,108743,455,200,GE-Phrase,253,108288,109302,1414
108288,108743,455,200,NTB,enfim,108332,108795,863
109847,110838,991,200,GE-Phrase,254,109302,110838,1936
109847,110838,991,200,GE-Phrase,255,110838,112804,2366
109847,110838,991,200,NTB,começamo já a fazer uma pasta no drive,109324,111392,2468
111271,112665,1394,200,GE-Phrase,255,110838,112804,2366
111271,112665,1394,200,GE-Phrase,256,112804,115094,2690
111271,112665,1394,200,NTB,,112120,112547,827
111271,112665,1394,200,NTB,enfim,112547,112850,703
111271,112665,1394,200,NTB,aí é uma reunião por semana,112850,114072,1622
113158,113509,351,200,GE-Phrase,256,112804,115094,2690
113158,113509,351,200,NTB,aí é uma reunião por semana,112850,114072,1622
115734,116783,1049,200,GE-Phrase,257,115094,116783,2089
115734,116783,1049,200,GE-Phrase,258,116783,118584,2201
115734,116783,1049,200,NTB,e aí,115690,116850,1560
115734,116783,1049,200,NTB,eu já tinha passado no pemegê,116850,118470,2020
117353,118033,680,200,GE-Phrase,258,116783,118584,2201
117353,118033,680,200,NTB,eu já tinha passado no pemegê,116850,118470,2020
119278,120248,970,200,GE-Phrase,259,118584,120891,2707
119278,120248,970,200,NTB,no programa de monitoria da faculdade,118470,120327,2257
121408,122859,1451,200,GE-Phrase,260,120891,123162,2671
121408,122859,1451,200,NTB,só que como as parada tavam meio incerta assim,120955,123333,2778
123543,125275,1732,200,GE-Phrase,261,123162,126484,3722
123543,125275,1732,200,NTB,então vou monitorar quem,124797,126007,1610
131270,132202,932,200,GE-Phrase,262,128821,132202,3781
131270,132202,932,200,GE-Phrase,263,132202,134077,2275
131270,132202,932,200,NTB,nũ tinha recebido nenhuma bolsa ainda né,131502,132715,1613
132712,133300,588,200,GE-Phrase,263,132202,134077,2275
132712,133300,588,200,NTB,tinha acabado de acontecer o processo,132715,134762,2447
134927,135782,855,200,GE-Phrase,264,134077,135782,2105
134927,135782,855,200,GE-Phrase,265,135782,138288,2906
134927,135782,855,200,NTB,e a mulher foi lá e falou olha & [/1],134762,136371,2009
136557,137175,618,200,GE-Phrase,265,135782,138288,2906
136557,137175,618,200,NTB,a minha tutora,136371,137155,1184
136557,137175,618,200,NTB,né,137155,137394,639
139895,141167,1272,200,GE-Phrase,266,138288,141167,3279
139895,141167,1272,200,GE-Phrase,267,141167,142467,1700
139895,141167,1272,200,NTB,cancelar as bolsas,139845,141078,1633
139895,141167,1272,200,NTB,e a gente volta quando retomar a aula,141078,143026,2348
141167,142045,878,200,GE-Phrase,267,141167,142467,1700
141167,142045,878,200,NTB,e a gente volta quando retomar a aula,141078,143026,2348
143704,144762,1058,200,GE-Phrase,268,142467,145380,3313
143704,144762,1058,200,NTB,mas tem como a gente fazer alguns trabalhos aqui nos bastidores,143026,145482,2856
145380,146062,682,200,GE-Phrase,269,145380,147413,2433
145380,146062,682,200,NTB,que eu acho que seria interessante da gente desenvolver,145482,147406,2324
147967,148742,775,200,GE-Phrase,270,147413,149490,2477
147967,148742,775,200,NTB,então optei por continuar com a bolsa,147685,149343,2058
150125,151219,1094,200,GE-Phrase,271,149490,151803,2713
150125,151219,1094,200,NTB,e a gente continua trabalhando,150838,152126,1688
152269,152957,688,200,GE-Phrase,272,151803,152957,1554
152269,152957,688,200,GE-Phrase,273,152957,155850,3293
152269,152957,688,200,NTB,falei ótimo,152126,152802,1076
152269,152957,688,200,NTB,perfeito,153018,153731,1113
153754,154804,1050,200,GE-Phrase,273,152957,155850,3293
153754,154804,1050,200,NTB,melhor que isso impossível assim,154046,155515,1869
156577,158207,1630,200,GE-Phrase,274,155850,158207,2757
156577,158207,1630,200,NTB,do grupo,157470,158208,1138
12418,13226,808,200,GE-Phrase,201,10096,15895,6199
12418,13226,808,200,NTB,criminal,12768,13241,873
16645,17651,1006,200,GE-Phrase,202,15895,18456,2961
16645,17651,1006,200,NTB,apresentar a denúncia,17388,18572,1584
18456,19037,581,200,GE-Phrase,203,18456,20099,2043
18456,19037,581,200,NTB,eu ficava na área cível,18788,20001,1613
21238,24524,3286,200,GE-Phrase,204,20099,25335,5636
21238,24524,3286,200,NTB,&dev [/1],24029,24452,823
21238,24524,3286,200,NTB,gente devendo dinheiro,24452,25541,1489
25972,26716,744,200,GE-Phrase,205,25335,28020,3085
25972,26716,744,200,NTB,ótimo,26592,27475,1283
36785,37576,791,200,GE-Phrase,206,35999,40113,4514
36785,37576,791,200,NTB,de tudo o que você pode imaginar,37442,38741,1699
41560,42418,858,200,GE-Phrase,207,40113,42418,2705
41560,42418,858,200,GE-Phrase,208,42418,44412,2394
42418,43624,1206,200,GE-Phrase,208,42418,44412,2394
42418,43624,1206,200,NTB,a pior de que eu já vi,42631,43912,1681
46121,46251,130,200,GE-Phrase,209,44412,46251,2239
46121,46251,130,200,GE-Phrase,210,46251,51709,5858
46251,47867,1616,200,GE-Phrase,210,46251,51709,5858
46251,47867,1616,200,NTB,hhh ele disse que caiu num esquema de pirâmide,46954,48939,2385
63328,64370,1042,200,GE-Phrase,211,62257,65386,3529
63328,64370,1042,200,NTB,ela começou o processo pra tentar recuperar a casa,62558,65598,3440
81436,82836,1400,200,GE-Phrase,212,80290,82836,2946
81436,82836,1400,200,GE-Phrase,213,82836,85414,2978
81436,82836,1400,200,NTB,isso eu ainda não trabalhava lá,81434,82665,1631
81436,82836,1400,200,NTB,,82665,83403,1138
82836,84829,1993,200,GE-Phrase,213,82836,85414,2978
82836,84829,1993,200,NTB,era no Lafayete,83403,84702,1699
82836,84829,1993,200,NTB,lá no Barro Preto,84702,85592,1290
85414,86507,1093,200,GE-Phrase,214,85414,86507,1493
85414,86507,1093,200,GE-Phrase,215,86507,88778,2671
85414,86507,1093,200,NTB,aí ele saiu correndo,85886,86831,1345
87662,88250,588,200,GE-Phrase,215,86507,88778,2671
87662,88250,588,200,NTB,acho que álcool,87433,88465,1432
89329,90131,802,200,GE-Phrase,216,88778,90860,2482
89329,90131,802,200,NTB,jogou no próprio corpo e ficou ameaçando colocar fogo,88465,90551,2486
91989,93966,1977,200,GE-Phrase,217,90860,95040,4580
91989,93966,1977,200,NTB,,92554,93922,1768
91989,93966,1977,200,NTB,é,93922,94195,673
95874,96212,338,200,GE-Phrase,218,95040,96841,2201
95874,96212,338,200,NTB,e aí na segunda audiência eu já tava lá,95393,96886,1893
98451,99474,1023,200,GE-Phrase,219,96841,99474,3033
98451,99474,1023,200,GE-Phrase,220,99474,101052,1978
98451,99474,1023,200,NTB,e aí na segunda audiência eu já tava lá,98109,99805,2096
100224,100638,414,200,GE-Phrase,220,99474,101052,1978
100224,100638,414,200,NTB,e aí meu chefe avisou que ele ia chegar,99805,100971,1566
101341,102117,776,200,GE-Phrase,221,101052,102768,2116
101341,102117,776,200,NTB,a audiência teve que ser de porta aberta,101511,102830,1719
103257,103943,686,200,GE-Phrase,222,102768,103943,1575
103257,103943,686,200,GE-Phrase,223,103943,105912,2369
103257,103943,686,200,NTB,,103637,104102,865
103257,103943,686,200,NTB,porque,104102,104669,967
103943,104750,807,200,GE-Phrase,223,103943,105912,2369
103943,104750,807,200,NTB,porque,104102,104669,967
103943,104750,807,200,NTB,,104669,105209,940
109435,110415,980,200,GE-Phrase,224,108166,110415,2649
109435,110415,980,200,GE-Phrase,225,110415,111999,1984
109435,110415,980,200,NTB,então hhh a gente já foi avisado uns dois dias antes,107909,110809,3300
110739,111504,765,200,GE-Phrase,225,110415,111999,1984
110739,111504,765,200,NTB,que a audiência dele ia acontecer,110809,111985,1576
111999,112384,385,200,GE-Phrase,226,111999,113239,1640
111999,112384,385,200,NTB,,111985,112539,954
111999,112384,385,200,NTB,pra todo mundo ficar preparado,112539,113640,1501
126183,127695,1512,200,GE-Phrase,227,125225,128489,3664
126183,127695,1512,200,NTB,coisa própria,127463,128133,1070
128634,128800,166,200,GE-Phrase,228,128489,129290,1201
128634,128800,166,200,NTB,eu falo a gente nũ mexe porque eu ainda não consegui desapegar,128133,130841,3108
129782,130588,806,200,GE-Phrase,229,129290,131192,2302
129782,130588,806,200,NTB,eu falo a gente nũ mexe porque eu ainda não consegui desapegar,128133,130841,3108
131192,132802,1610,200,GE-Phrase,230,131192,135194,4402
131192,132802,1610,200,NTB,já tem mais de seis meses que eu não trabalho lá,131445,133263,2218
143636,144245,609,200,GE-Phrase,231,143032,144677,2045
143636,144245,609,200,NTB,os filhos começam a brigar,142771,144859,2488
145434,146175,741,200,GE-Phrase,232,144677,147741,3464
145434,146175,741,200,NTB,,145652,146076,824
145434,146175,741,200,NTB,sai do meu terreno,146076,146937,1261
